NO ./xpm/north.xpm
SO ./xpm/south.xpm
WE ./xpm/west.xpm
EA ./xpm/east.xpm

F 127,127,127
C 255,255,0

1111111111111111111111111
1000000000110000000000001
10110000011100000W0000001
100100000000000000000000111111111
111111111011000001110000000000001
100000000011000001110111111111111
11110111111111011100000000001
11110111111111011101010010001
11000000110101000000000010001
10000000000000001100000010001
10000000000000001101010010001
1100000111010101111101111000111
11110111 1110101 101111010001
11111111 1111111 111111111111